_________________________________________
__##########_____#######_________________
__#........#_____#.....#_________________
__#........#_____#.....#_________________
__#........#_____#######_________________
__#........#_______#.#___________________
__##########_______#.#___________________
________________####.####________________
_________________________________________
_________________________________________
_________________________________________
_________________________________________
_________________________________________
_________________________________________
_________________________________________
_________________________________________
_________________________________________
_________________________________________
_________________________________________
_________________________________________
_________________________________________
_________________________________________
_________________________________________
__________________________________________