_________________________________________
_________________________________________
_____________##########__________________
____###########.......#######____________
____#........##.......#.....#____________
____#.......................#____________
____#........##.......#.....#____________
____#........############.###____________
____##########__________#.#______________
_____________________####.####___________
_________#######_____#.......#___________
______####.....#_____#.......####________
______#..#.....#######..........#________
______####......................#________
_________######...####..........#________
_____________#.......############________
_____________#.......#########___________
_____________#.......##.....##___________
_____________#..............##___________
_____________#################___________
_________________________________________
_________________________________________
_________________________________________
__________________________________________