_________________________________________
_#######_________________________________
_#.....##############____________________
_#..................#______#########_____
_#.....#####.....####___####.......#_____
_#.....#___#.....#______#..........#_____
_####.##___#.....#______#..........###___
____#.#____#.....####___#............#___
____#.#____#........#___#............#___
#####.#____#........#___##############___
#.....#____###.######____________________
#.....#______#.#_________________________
#######______#.#_____##############______
_____________#.####__#............#______
_____________#....#__#............#______
_____________#....####............#______
_____________#...............######______
_____________#########.......#___________
__________________####.......#___________
__________________#..........#___________
__________________############___________
_________________________________________
_________________________________________
__________________________________________