_________________________________________
_#######_________________________________
_#.....##############____________________
_#..................#____________________
_#.....#####.....####____________________
_#.....#___#.....#_______________________
_#######___#.....#_______________________
___________#.....####____________________
___________#........#____________________
___________#........#____________________
___________##########____________________
_________________________________________
_________________________________________
_________________________________________
_________________________________________
_________________________________________
_________________________________________
_________________________________________
_________________________________________
_________________________________________
_________________________________________
_________________________________________
_________________________________________
__________________________________________