_________________________________________
__#######________________________________
__#.....##############___________________
__#..................#______#########____
__#.....#####.....####___####.......#____
__#.....#___#.....#______#..........#____
__####.##___#.....#______#..........###__
_____#.#____#.....####___#............#__
_____#.#____#........#___#............#__
_#####.#____#........#___##############__
_#.....#____###.######___________________
_#.....#______#.#________________________
_#######______#.#_____##############_____
______________#.####__#............#_____
______________#....#__#............#_____
______________#....####............#_____
______________#...............######_____
______________#########.......#__________
___________________####.......#__________
___________________#..........#__________
___________________############__________
_________________________________________
_________________________________________
__________________________________________